##################################
#..........#..............#..E....
#........P.#..............#......#
#..........#..............#......#
#..........#.....######...########
#.##########.....#....#..........#
#................#..1.#..........#
#................#....#..........#
#................####.#..........#
#..........................#####.#
#..........................#...2.#
#..........................#.....#
##################################
