##################################
#..........#..............#......W
#........P.#..............#......#
#..........#..............#......#
#..........#.....######...######.#
#.##########.....#....#..........#
#................#..1.#..........#
#................#....#..........#
#................####.#..........#
#..........................#####.#
#..........................#...2.#
#..........................#.....#
##################################
