##################################
#.P..............................#
#................................#
#................................#
#................................#
#................................#
#................................#
#................................#
.................................#
#...................E............#
#................................#
#................................#
##################################
